0x00000000 0x08000000 0x00000000 0
0xA2001c00 0xA2011C00 0x00000000 1
0xA5000000 0xA6000000 0x00000000 2
0xA8000000 0xA9000000 0x00000000 3
0xAA000000 0xBA000000 0x00000000 4
0xA4000000 0xA5000000 0x00000000 5
0x08000000 0x08001000 0x08000000 0
