0x00000000 0x10000000 0x00000000 0
0xA7000000 0xA8000000 0x00000000 1
0xA5000000 0xA6000000 0x00000000 2
0xA8000000 0xA9000000 0x00000000 3
0xAA000000 0xBA000000 0x00000000 4
0xA9000000 0xA9100000 0x00000000 5
0xA4000000 0xA5000000 0x00000000 6
0x00000000 0x10000000 0x00000000 7
0x00000000 0x10000000 0x00000000 8
0x00000000 0x10000000 0x00000000 9
0xBA000000 0xBB000000 0x00000000 10
0xA6000000 0xA7000000 0x00000000 11
0x10000000 0x10001000 0x10000000 0
