0x00000000 0x08000000 0x00000000 0
0xC0000000 0xC0000040 0x00000000 1
0xC2000000 0xC2000100 0x00000000 2
0xC1000000 0xC1000010 0x00000000 3
0xC1000010 0xC1000020 0x00000000 4
0x80000000 0x80001000 0x08000000 0