0x00000000 0x08001000 0x00000000 5
0xA7000000 0xA8000000 0x00000000 6
0xA5000000 0xA6000000 0x00000000 7
0xA8000000 0xA9000000 0x00000000 8
0xAA000000 0xAB000000 0x00000000 9
0xA9000000 0xA9100000 0x00000000 10
0xA6000000 0xA7000000 0x00000000 12
0xA4000000 0xA5000000 0x00000000 13
0xAC000000 0xAC010000 0x00000000 1
