0x00000000 0x01401000 0x00000000 4
0xC1000000 0xC1000020 0x00000000 0
0xC3000000 0xC3010000 0x00000000 1
0xC4000000 0xC4000200 0x00000000 2
0xC2000000 0xC2000010 0x00000000 3
0xC5000000 0xC5001000 0x00000000 11
